WE ./textures/oswall1.xpm
NO ./textures/oswall2.xpm
SO ./textures/oswall3.xpm
EA ./textures/oswall4.xpm

F 255,255, 10
C 225,255,255

1111111111 1
1011000111 111111111
1110001111111 1111
1100000001 1 111 1 111
1000E0010111111111111
10000000011     1
1111111111 1111
