WE ./textures/oswall1.xpm
NO ./textures/oswall2.xpm
SO ./textures/oswall3.xpm
EA ./textures/oswall4.xpm

F 255,255, 10
C 225,255,255

1111111111 1
1011000111 111111111
11 0 01111111 1111
11000001 1 111 1 111
1000S0011     1
1111111111 1111
