WE ./textures/wall_3.xpm
NO ./textures/wall_1.xpm
SO ./textures/wall_2.xpm
EA ./textures/wall_4.xpm

F 255,255, 10
C 225,255,255

111111111
101100011
11 101001
110000011
1000S0011
111111111
