NO ./path_to_the_north_texture
SO ./path_to_the_south_texture
WE ./path_to_the_west_texture
EA ./path_to_the_east_texture

F 159, 226, 191
C 0,255, 255

      1111111111111111111111111
111111000000000110000000000001
101100000111000000000000111111
100100000000000000000000111111111
1111111110110000011100000000000011
            100000000011000001110111111111111
1111011111111101110000001000111111
11110111111111011101010010001
11000000110101011100000010001
1000000000000     0001100000010001
1000000000000     0001101010010001
11000001110101011111011110N0111
11110111 1110101 101111010001
11111111 1111111 111111111111


