WE ./textures/wall_3.xpm
NO ./textures/wall_1.xpm
SO ./textures/wall_2.xpm
EA ./textures/wall_4.xpm

F 255,255, 10
C 225,255,255

11111111111111111111111111111111111111111111111111
10000000001100000000000011000000000110000000000001
10110000011100000000000011011000001110000000000001
10010000000000000000000011001000000000000000000001
11111111101100000111000011111111110110000011100001
1000000000110E000111011111000000000110000011101111
11110111111111011100000011111011111111101110000001
11110111111111011101010011111011111111101110101001
11000000110101011100000011100000011010101110000001
10000000000000001100000011000000000000000110000001
10000000000000001101010011000000000000000110101001
11000001110101011111011111100000111010101111101111
11110111011101010101111011111011101110101010111101
11111111111111111111111111111111111111111111111111
