WE ./textures/wall_3.xpm
NO ./textures/wall_1.xpm
SO ./textures/wall_2.xpm
EA ./textures/wall_4.xpm

F 255,255, 10
C 225,255,255

11111111
10010001
10101001
11000001
1000W001
11111111
