WE ./textures/oswall4.xpm
NO ./textures/oswall4.xpm
SO ./textures/oswall4.xpm
EA ./textures/oswall4.xpm

F 255,255, 10
C 225,255,255

1111111111 1
1011000111 111111111
1110001111111 1111
11000001 1 111 1 111
1000000111111111111
1000N1011     1
1111111111 1111
