WE ./textures/wall_3.xpm
NO ./textures/wall_1.xpm
SO ./textures/wall_2.xpm
EA ./textures/wall_4.xpm

F 255,255, 10
C 225,255,255

1111111111111111111111111
1000000000110000000000001
1011000001110000000000001
1001000000000000000000001
1111111110110000011100001
1000000000110000011101111
1111011111111101110000001
1111011111111101110101001
110000001101010111S000001
1000000000000000110000001
1000000000000000110101001
1100000111010101111101111
1111011111110101110111101
1111111111111111111111111
