WE ./textures/wall_3.xpm
NO ./textures/wall_1.xpm
SO ./textures/wall_2.xpm
EA ./textures/wall_4.xpm

F 255,255, 10
C 225,255,255

1111111111 1
1011000111 111111111
11 0 01111111 1111
11000001 1 111 1 111
1000S00110     1
1111111111 1111
