WE ./textures/wall_3.xpm
NO ./textures/wall_1.xpm
SO ./textures/wall_2.xpm
EA ./textures/wall_4.xpm

F 255,255, 10
C 225,255,255

1111111111
1011000111 1
11 0 011111
11000001 1
1000S001 1
1111111111
