WE ./textures/oswall.xpm
NO ./textures/oswall2.xpm
SO ./textures/oswall3.xpm
EA ./textures/oswall4.xpm

F 255, 255, 10
C 225, 105, 5

1111111111
1011000111
1110001111
11000000011
10000E0101
1000000011
1111111111
